# Avalon UGH Level 03
# Ridge, Platform, Bridge, Stone
S444S2S444SSSS2S2SSS
2222442222SSS2233C2S
S2S244S2SSSSSSS3322S
33S24422SSSSSPP2P2P2
3322S2S2SSSSSSSSS222
SC2S33S2SSSSSSSSSSSS
S22S3322SS2SSSSSSSSS
P2P2PP2S222SSS2SSSSS
22SSSSS33SSSS44SSSSS
SSSSS2S33SSSS44S2SSS
SSSS44SSS2SSS4444S2S
SSSS44S233SSSC24433S
SSSS442233SSS224433S
SSSSPPP2BBBP2PPPSS2S
SSSR2R22SSS22R2R222S
SSS22RRRSSSRR2222RSS
# end