# Avalon UGH Level 03
# Ridge, Platform, Bridge, Stone
SSSSSSSSSSSSSSSSSSSS
SSSSSSSSSSSSSSSSSC2S
SSSSSSSSSSSSSSSSS22S
SSSSSSSSSSSSSPP2P2P2
SSSSSSSSSSSSSSSSSS22
SC2SSSSSSSSSSSSSSSSS
S22SSSSSSSSSSSSSSSSS
P2P2PP2SSSSSSSSSSSSS
22SSSSSSSSSSSSSSSSSS
SSSSSSSSSSSSSSSSSSSS
SSSSSSSSSSSSSSSSSSSS
SSSSSSSSSSSSSC2SSSSS
SSSSSSSSSSSSS22SSSSS
SSSSPPP2BBBP2PPPSSSS
SSSR2R22SSS22R2R2SSS
SSS22RRRSSSRR2222RSS
# end