# Avalon UGH Level 02
# Ridge, Platform, Bridge, Stone
R2
22
R2
22S2
R222       C2
22SC2      22
R2F22S2P444P2BBBP444
22P2P22222233S2S2222
R2RS444S4443322SS2S2
22S22222222SSSS24444
S444S444S444S2334444
22222222222222334444 
P2PBBBBBBBP2PPBBBPP2
22S2S2S44422S444S222
R222442222S2222222S2
22S244S2S244S2S2S444
R2224422S24422442222
22S2S2C24444S244S2S2
R233222244S233443333
2233S2P2442233S23333